Wedding - свадьба
Most of all - больше всего 
Suspicious - подозрительно 
Conversation - беседа
Perhaps - возможно 
Fair - 1. Ярмарка, 2. Справедливо 
Journey - путешествие 
Climb - взбираться 
Through - через
Noise - шум

Generous - щедрый
Shy - застенчивый 
Enthusiasm - энтузиазм

Hospitable - гостеприимный
Below (something) - ниже 
Thin - тонкий
Manufacture - производство 

Confident - уверенный

Curious - любопытный
Attempt - попытка 
Conclusion - вывод
Impressive - впечатляющий 
Ill - болен
present - присутствовать
absent - отсутствовать
Unlikely - маловероятно 
Fault - вина
Ahead - впереди

Unpredictable - непредсказуемый
Thoughtful - задумчивый 
Date - 1. Дата, 2. Свидание 
Composition - сочинение 
